*FF*...**FFC.C.**..*C*.*..CJ..**......**......******************
*..******..FF****..FF*****.*******.*........CJC..*.*.CC....*....
*F*.....*J*...C.*.*.....*.*.....*.*.....*.*.....*...CCC.*...FFF.
F..FF**F*..***.C*..***.......*...CC..*.......**C.....**.J.......
FJ.FF**F*CC****C*..***..*..***..*..***..**.****C**.****.**......
F*......F*.CCCC.F*......F*......J...............................
F.F..F.F..............................C......CJC......C.........
F.F..F.FC.C..CC........................................J........
